0 0 0 0 0 1 1 1 1 1 1 1 1 1 0 0 0 0 0
0 0 0 0 0 1 5 3 5 1 5 3 5 1 0 0 0 0 0
0 0 0 0 0 1 3 5 3 5 3 5 3 1 0 0 0 0 0
0 0 0 0 0 1 5 3 5 3 5 3 5 1 0 0 0 0 0
0 0 0 0 0 1 3 5 3 5 3 5 3 1 0 0 0 0 0
0 0 0 0 0 1 5 3 5 3 5 3 5 1 0 0 0 0 0
0 0 0 0 0 1 1 1 0 0 0 1 1 1 0 0 0 0 0
0 0 0 0 0 0 0 1 0 0 0 1 0 0 0 0 0 0 0
0 0 0 1 1 1 1 1 1 0 1 1 1 1 1 1 0 0 0
0 0 0 1 0 0 0 0 0 0 0 0 0 0 0 1 0 0 0
0 0 0 1 0 2 0 2 0 2 0 2 0 2 0 1 0 0 0
0 0 0 1 1 0 2 0 2 0 2 0 2 0 1 1 0 0 0
0 0 0 0 1 2 0 2 0 2 0 2 0 2 1 0 0 0 0
0 0 0 0 1 0 0 0 2 4 2 0 0 0 1 0 0 0 0
0 0 0 0 1 0 0 1 1 1 1 1 0 0 1 0 0 0 0
0 0 0 0 1 1 1 1 0 0 0 1 1 1 1 0 0 0 0
